WE west
NO north
EA east
SO south
C 255,255,255
F 0,0,0


11111111111
10000010001
10000010001
10000010001
10000011001
10000000001
11111111111