NO assets/North.xpm
WE assets/West.xpm
EA assets/East.xpm
SO assets/South.xpm


C 60,60,144
F 50,50,50

11111
10001
10101  111
10001  101
10N01  111
10001
11111