WE assets/West.xpm
NO assets/North.xpm
EA assets/East.xpm
SO assets/South.xpm
C 60,60,240
F 50,50,50

11111
10001
10E01
10001
11111