NO assets/North.xpm
WE assets/West.xpm
EAS assets/East.xpm
SO assets/South.xpm

C 60,60,251
F 50,50,50

11111
11111
11E11
11111
11111