WE assets/cobblestone.xpm
NO assets/cobblestone.xpm
EA assets/cobblestone.xpm
SO assets/cobblestone.xpm
C 255,255,255
F 1,2,2

111111111111111
10001      101
10000      111
10001
11111