WE assets/cobblestone.xpm
NO assets/cobblestone.xpm
EA assets/cobblestone.xpm
SO assets/cobblestone.xpm
C 255,255,255
F 1,2,2

11111
10001
10001
10000
11111