WE assets/cobblestone.xpm
NO assets/cobblestone.xpm
EA assets/cobblestone.xpm
SO assets/cobblestone.xpm
C 255,255,255
F 1,2,2

11111
1000111111111111111
1000000000000000001
1000000011111111111
111111001
     1001
     100111111111111
     100000000000001
     111111111111111