WE assets/cobblestone.xpm
NO assets/cobblestone.xpm

EA assets/cobblestone.xpm
SO assets/cobblestone.xpm
C 60,60,240
F 50,50,50


       111
       101
 11111 111
 10001
 10N01
 10001
 11111

  111
  101
  111