WE assets/cobblestone.xpm
NO assets/cobblestone.xpm

EA assets/cobblestone.xpm
SO assets/cobblestone.xpm
C 60,60,240
F 50,50,50















                       111
                       101
 11111                 111
 10001111111111111111
 10N000000000000000101
 10000000111110111111
 111111001   1011111
      1001  10000001
      100111111111101
      10000000000001
      111111111111111

