WE assets/cobblestone.xpm
NO assets/cobblestone.xpm
EA assets/cobblestone.xpm
SO assets/cobblestone.xpm
C 60,60,240
F 50,50,50

111111111111111111111111111111111111
100000000000000000000000000000000001
101111111111111111111111111111111101
101000000000000000000000000000001101
101011111111111111111111111110001101
101000000000000000000000000010001101
101011111111111111111111111110001101
101000000000000000000000000010001101
101111111111111111111111111111111101
100000000000000000000000000000000001
100011111111111111111111111111111001
100010000000000000000000000000000001
100010111111111111111111111111111101
100010100000000000000000000000000101
100010101111111111111111111111101101
100010100000000000000000000000101101
100010101111111111111111111110101101
100000000000000000000N00000000000011
111111111111111111111111111111111111
