NO assets/mc/grass.xpm
WE assets/mc/cobblestone.xpm
EA assets/mc/tnt.xpm
SO assets/mc/diamond.xpm

C 0,60,251
F 50,50,50

11111
1000111111111
10E0000000001
1000111110111
11111   101
        101
        111