NO assets/other/foot.xpm
WE assets/other/foot.xpm
EA assets/other/foot.xpm
SO assets/other/tiger.xpm

C 60,60,251
F 50,50,50

11111
10001
10E011
1000001111
11100000001
   1111111